111111111111111111111111111111111111111111111111111111111111111
11....................11111111111111111111111111111111111111111
11.........P..........11111111111111111111111111111111111111111
1.............................................................1
1.............................................................1
1.............................................................1
1........1111111111111....................111111111111........1
1........1111111111111.........111........111111111111........1
1........1111111111111.........1.1........111111111111........1
1........1111111111111.........111........111111111111........1
1........1111111111111....................111111111111........1
1.............................................................1
1.............................................................1
1.............................................................1
1.....1111.....1111......1111......1111.....1111.....1111.....1
1.....1111.....1111......1111......1111.....1111.....1111.....1
1.....1111.....1111......1111......1111.....1111.....1111.....1
1.............................................................1
1.............................................................1
111111....11111....111111....111111....11111....11111....111111
111111....11111....111111....111111....11111....11111....111111
111111....11111....111111....111111....11111....11111....111111
1.............................................................1
1.............................................................1
1.....1111.....1111......1111......1111.....1111.....1111.....1
1.....1111.....1111......1111......1111.....1111.....1111.....1
1.....1111.....1111......1111......1111.....1111.....1111.....1
1.............................................................1
1.............................................................1
111111....11111....111111....111111....11111....11111....111111
111111....11111....111111....111111....11111....11111....111111
111111....11111....111111....111111....11111....11111....111111
1.............................................................1
1.............................................................1
1.............................................................1
1........1111111111111....................111111111111........1
1........1111111111111........111.........111111111111........1
1........1111111111111........1.1.........111111111111........1
1........1111111111111........111.........111111111111........1
1........1111111111111....................111111111111........1
1.............................................................1
1.............................................................1
1.............................................................1
1.............................................................1
11111111111111111111111111111111111111.............Q..........1
11111111111111111111111111111111111111........................1
111111111111111111111111111111111111111111111111111111111111111

