111111111111111111111111111111111111111111111111111111111111111111111111111111111111111111111111111
111111111111111111111111111111111111111111111111111111111111111111111111111111111111111111111111111
111111111111111111111111111111111111111111111111111111111111111111111111111111111111111111111111111
111111111111111111111111111111111111111111111111111111111111111111111111111111111111111111111111111
111111111111111111111111111111111111111111111111111111111111111111111111111111111111111111111111111
111111111111111111111111111111111111111111111111111111111111111111111111111111111111111111111111111
111111111111111111111111111111111111111111111111111111111111111111111111111111111111111111111111111
111111111111111111111111111111111111111111111111111111111111111111111111111111111111111111111111111
111111111111111111111111111111111111111111111111111111111111111111111111111111111111111111111111111
111111111111111111111111111111111111111111111111111111111111111111111111111111111111111111111111111
111111111111111111111111111111111111111111111111111111111111111111111111111111111111111111111111111
11111111111111111111....................11111111111111111111111111111111111111111111111111111111111
11111111111111111111.........P..........11111111111111111111111111111111111111111111111111111111111
1111111111111111111.............................................................1111111111111111111
1111111111111111111................................................P............1111111111111111111
1111111111111111111.............................................................1111111111111111111
1111111111111111111.............................................................1111111111111111111
1111111111111111111........1111111111111....................111111111111........1111111111111111111
1111111111111111111........1111111111111.........111........111111111111........1111111111111111111
1111111111111111111........1111111111111.........1.1........111111111111........1111111111111111111
1111111111111111111........1111111111111.........111........111111111111........1111111111111111111
1111111111111111111........1111111111111....................111111111111........1111111111111111111
1111111111111111111.............................................................1111111111111111111
1111111111111111111.............................................................1111111111111111111
1111111111111111111.............................................................1111111111111111111
1111111111111111111.............................................................1111111111111111111
1111111111111111111.....1111.....1111......1111......1111.....1111.....1111.....1111111111111111111
1111111111111111111.....1111.....1111......1111......1111.....1111.....1111.....1111111111111111111
1111111111111111111.....1111.....1111......1111......1111.....1111.....1111.....1111111111111111111
1111111111111111111.............................................................1111111111111111111
1111111111111111111.............................................................1111111111111111111
1111111111111111111.............................................................1111111111111111111
1111111111111111111......11111.....111111.....111111......11111......11111......1111111111111111111
1111111111111111111......11111.....111111.....111111......11111......11111......1111111111111111111
1111111111111111111......11111.....111111.....111111......11111......11111......1111111111111111111
1111111111111111111.............................................................1111111111111111111
1111111111111111111.............................................................1111111111111111111
1111111111111111111.............................................................1111111111111111111
1111111111111111111.....1111.....1111......1111......1111.....1111.....1111.....1111111111111111111
1111111111111111111.....1111.....1111......1111......1111.....1111.....1111.....1111111111111111111
1111111111111111111.....1111.....1111......1111......1111.....1111.....1111.....1111111111111111111
1111111111111111111.............................................................1111111111111111111
1111111111111111111.............................................................1111111111111111111
1111111111111111111.............................................................1111111111111111111
1111111111111111111......11111.....111111.....111111......11111......11111......1111111111111111111
1111111111111111111......11111.....111111.....111111......11111......11111......1111111111111111111
1111111111111111111......11111.....111111.....111111......11111......11111......1111111111111111111
1111111111111111111.............................................................1111111111111111111
1111111111111111111.............................................................1111111111111111111
1111111111111111111.............................................................1111111111111111111
1111111111111111111.............................................................1111111111111111111
1111111111111111111........1111111111111....................111111111111........1111111111111111111
1111111111111111111........1111111111111........111.........111111111111........1111111111111111111
1111111111111111111........1111111111111........1.1.........111111111111........1111111111111111111
1111111111111111111........1111111111111........111.........111111111111........1111111111111111111
1111111111111111111........1111111111111....................111111111111........1111111111111111111
1111111111111111111.............................................................1111111111111111111
1111111111111111111.............................................................1111111111111111111
1111111111111111111......Q......................................................1111111111111111111
1111111111111111111.............................................................1111111111111111111
11111111111111111111111111111111111111111111111111111111.............Q..........1111111111111111111
11111111111111111111111111111111111111111111111111111111........................1111111111111111111
111111111111111111111111111111111111111111111111111111111111111111111111111111111111111111111111111
111111111111111111111111111111111111111111111111111111111111111111111111111111111111111111111111111
111111111111111111111111111111111111111111111111111111111111111111111111111111111111111111111111111
111111111111111111111111111111111111111111111111111111111111111111111111111111111111111111111111111
111111111111111111111111111111111111111111111111111111111111111111111111111111111111111111111111111
111111111111111111111111111111111111111111111111111111111111111111111111111111111111111111111111111
111111111111111111111111111111111111111111111111111111111111111111111111111111111111111111111111111
111111111111111111111111111111111111111111111111111111111111111111111111111111111111111111111111111
111111111111111111111111111111111111111111111111111111111111111111111111111111111111111111111111111
111111111111111111111111111111111111111111111111111111111111111111111111111111111111111111111111111
111111111111111111111111111111111111111111111111111111111111111111111111111111111111111111111111111
111111111111111111111111111111111111111111111111111111111111111111111111111111111111111111111111111
111111111111111111111111111111111111111111111111111111111111111111111111111111111111111111111111111
